╬  ═  ╦   ╩   ║   ╣   ╠   ╗   ╝   ╚   ╔  █

█═╦════════════════╗╔══════════╦════╗..╔══╦═╦══╗.
.╔╩═════╗..........╠╣..........║....║..║..║.║..║.
.║..╦╦══╣..╔════╗..║╚════╗.....║....║..║..║.║..║.
.║.╔╣╠══╣..║....║..║.....╚╗....║....║..║..╚═╝..═.
╔╝.║╚╝..╚══╝.╔══╬══╝......╚════╝....║..║.......║.
║..║╔══════╦╗║..║......╔════════╗.╔═╝..╚╗...█══╝.
║..║╚═══╗..║║║..╚══════╬═══╦══╗.╠═╬════╦╝........
╠══╝....║..║╚╩════╦════╝.╔═╣..╠═╣.╠══╦═╬══╗..█...
╚═════╗.║..║╔═════╩══════╝.║..║.║.╠═╗╚═╝..║..║...
╔═════╝.╚═╦╣╠═══╦══════════╝..║.║.╠═╩═╦═══╣..═...
╚═════════╩╝╚═══╩═════════════╩═╩═╝...╚═══╩══╝...